1111111111111
1000000010001
1000100000101
1000111110001
1000000010001
1111111111111
